6 5 2 5 2 5 2 5 2 5 2 5 2 5 2 5 2 5 2 6
4 14 12 14 14 9 14 14 14 9 14 4 14 14 14 12 14 12 14 4
4 14 14 9 14 14 14 14 12 14 14 4 12 14 14 9 14 14 14 4
4 4 14 4 4 4 4 4 4 14 14 4 4 4 4 4 14 9 14 4
4 4 9 14 14 14 14 14 4 14 14 4 14 14 14 4 9 14 14 4
4 4 14 14 14 14 12 14 4 9 14 4 14 9 14 4 14 14 14 4
4 4 4 4 4 4 14 14 4 14 14 4 14 14 14 4 14 14 14 4
4 14 12 14 14 14 14 9 4 14 14 4 14 9 4 4 14 14 14 4
4 14 14 14 14 12 9 14 4 9 12 14 14 12 14 14 14 12 14 4
4 14 9 14 14 14 14 14 4 14 0 7 14 4 4 4 4 4 4 4
4 14 12 14 9 12 14 14 4 14 10 14 12 14 12 14 14 14 14 4
4 14 14 14 14 14 14 14 4 14 14 14 4 14 14 14 14 9 14 4
4 14 12 14 4 4 4 4 4 14 14 14 4 14 14 14 14 14 14 4
4 4 4 4 14 14 14 12 12 9 14 14 4 14 14 9 12 14 14 4
4 14 14 12 12 14 14 14 14 12 14 14 4 4 14 14 4 4 4 4
4 14 12 14 4 14 14 14 12 14 14 14 14 4 14 4 14 9 14 4
4 14 14 9 14 14 4 14 14 9 14 14 12 4 14 14 9 14 14 4
4 14 9 14 14 14 4 12 14 14 9 14 14 4 14 14 14 14 14 4
4 12 14 14 14 14 4 14 14 14 14 14 14 4 14 12 14 14 14 4
4 5 2 5 2 5 2 5 2 5 2 5 2 5 2 5 2 5 2 4
